R 1000 700

NO ./assets/textures/1375EA.xpm
SO ./assets/textures/1375SO.xpm
WE ./assets/textures/1375WE.xpm
EA ./assets/textures/1375NO

F 72,80,83
C 105,105,105

S ./assets/sprites/guard.xpm

        1111111111111111111111111
        1000000000110000E12000001
        1011000001110020112000001
        1001000000000000212000001
111111111011000001110001112000001
100000000011000001110111111111111
11110111111111011100000010001
11110111111111011101010010001
11000000110101011100000010001
10000000000000001100000010001
10000000000000001101010010001
110000011101010111110111100111
11110111 1110101 101111010001
11111111 1111111 111111111111
   
   11111

   