R 1000 1000

   NO   ./assets/textures/1375EA.xpm      
SO    ./assets/textures/1375SO.xpm   
   WE ./assets/textures/1375WE.xpm
  EA ./assets/textures/1375WE.xpm
  F   200,200,200
  C    0,191,255

      S       ./assets/sprites/coin .xpm


        1111111111111111111111111
        1000000000110000000000001
        1011000001110000002000001
        1001000000020000000000001
111111111011000001110222222200001
100000000011000001110111111111111
111111111111111111111111111111111
      
111111111111111111111111111111111
11110111111111N11100000010001
11110111111111011101010010001
11000000110101011100000010001
10002000000000001100000010001
10000000000000001101010010201
1100000111010101111101111000111
11110111 1110101 101111010001
11111111 1111111 111111111111
