R  800 800
NO ./assets/textures/1375EA.xpm
SO ./assets/textures/1375SO.xpm
WE ./assets/textures/1375WE.xpm
EA ./assets/textures/   13 75NO ds
  
F  200,200,200
C  0,  191,255

SC ./assets/sprites/coin .xpm | 70 | 6 | 1 | 5 |  6 | 0
SC ./assets/sprites/coin .xpm | 70 | 7 | 1 | 5 |  6 | 0
SC ./assets/sprites/coin .xpm | 70 | 8 | 1 | 5 |  6 | 0
S ./assets/sprites/guard.xpm | 58 | 17 | 0 | 1 |  0 | 0
SC ./assets/sprites/coin .xpm | 70 | 5 | 1 | 5 |  6 | 0
ST ./assets/sprites/meal.xpm | 72 | 5 | 0 | 5 |  60 | 0
SH ./assets/sprites/heal.xpm | 71 | 5 | 0 | 5 |  60 | 0


111           11                                        111111111111111111111111111111111111111111
101                                                     10000000000000000000000000000000000000000011
111                                                     100000000000000000000000000000000000000000011
                                                        100000000000000D000000000000000000000000000011
              1111111  111111111111111111111            10000000000000000000000000000000000000000000011
           1111100001  100011111000000001001            1000000000000W0000000000000000000000000000000011
        1111100000001  100000011110111111101            1000000000000000000000000000000000000000000000011
  1111111100000000001  10000000000011    101            10000000000000000000000000000000000000000000000011
  1000000000000000001  10000000000111   1101111111      100000000000000000000000000000000000000000000000011
  1100000000000000001  10000000000001   11000000001     1000000000000000000000000100000000000000000000000011
  1111111111111111111  11111110111111   11111111101     10000000000000000000000010100000000000000000000000011
                            10001               101     100000000000000000000000011100000000000000000000000011
  11111111111111111     11110001111111111111   101111  1000000000000000000000001110100000000000000000000000011
 111000000000000011    1100000000000000000001   100001  10000000000000000000000111111100000000000000000000000011
  10000000000000001    1000000000000000000001   1100011 100000000000000000000000000001100000000000000000000000011
  11000000000000011    1100000000000111110001   1000001 1000000000000000000000111111100000000000000000000000011
  1000000000000001      1000000000001   10001   1000001 1000000000000000000000001111100000000000000000000000011
  11100000000000011111111000000000001   10001   11000011100000000000000000000000011100000000000000000000000011
   1111000000000000001000000000000001   10001  11100000000000000000000000000000000100000000000000000000000011
   1100000000000000000000000001111111   11111  1000111111000000000000000000000000000000000000000000000000011
   11111000001100000000000000000001            10001    100000000000001000000000000000000000000000000000011
 111000000000000000000000000001111111111111111110001    10000000000000100000000000000000000000000000000011
 111111000000000000000000000000000000000000000000001    1000000000000010000000000000000000000000000000011
     11111100000000000000000011111111111111111000001    100000000000001000000000000000000000000000000011
         1111110000000000111111            111111111    10000000000000000000000000000000000000000000011
             11111111111111                             1000000000000000000000000000000000000000000011
                                                        100000000000000000000000000000000000000000011
                                                        10000000000000000000000000000000000000000011
                                                        1111111111111111111111111111111111111111111
                                                                                1