NO    ./texture/mossy.xpm     
S ./texture/barrel.xpm  
SO         ./texture/greystone.xpm   
EA ./texture/bluestone.xpm
WE      ./texture/redbrick.xpm    
C  153,204,255
R    1280 800
F    224,224,224


            111
           110111111
           100000001
          11020100011
         1110010100111
         1000001000001
111111111100000000000111111111111111111111111111111111111111111111111111
100000000000000100200000000000000000000000000000000000000000000000000001
101111111111000101001111111111111111111110111111111111011111111111011111
101      11000100011                    101          101         101
101       100000001                     101          101         101
101       111000111111111111111111111111110111        101         101
101          100000000000000000000000000000001     11110111       101
10111111111111111111111100111111111011011111101     10000001       101
100000002000N020000000000011     100001 111011111111011110111111111101
11111111111111111110000111111111111000011110000000000001 10000000000001
                  10000000000000000000000001111111111111 11111111111111
                  11111111111111111111111111