
R     1280 800

NO      ./texture/mossy.xpm     

SO ./assets/textures/1375EA.xpm   

WE ./texture/greystone.xpm
EA ./texture/redbrick.xpm

S ./assets/sprites/guard.xpm

F    224,224,224
C       204,229,255


        1111111111111111111111111
        1000020000000000000000001
        10110000002000000200000111
        10010000N0000020000000001
111111111011000000000000000010001
100000000000000000000111110111111
11110111111111011100000010001
11110111111111001101010010001
11000000110101001100000010001
10000000000000001100000010001
10020002000200001101010010001
1100000111010001111101111000111
11110111 1110001 101111010001
11111111 1111111 111111111111